10000000000000000000000000000000000000000000000001
10000000000000000000000000000000000000000000000001
10000000000000000000000000000000000000000001111111
10000000000000000000000000000000000000000011111111
10000000000000000000000000000000000000000111111111
19991000000000000000000000000000000000001111111111
11111000000000000000000000000000000000111111111111
11100000000000000000000000000000000001111111111111
11000000000000000000000000000000000001100000000001
10000000000001111110000000000000000000000000000001
10000000000000111100000000000000700000000000000001
10000000000000000000000000000000100000000000000001
10000000000000000000000000111111111111111111100001
10000000000000000000000000999111111111111111000011
10000000000000000000000000911100000000000000000111
10000000000000000000000000911000000000000000001111
10000000000000000000000000911000000000000000011111
10000000000000000222000000911000000000000000111111
10000000002200002200000000911000000000000001111111
10000000000222022000000000911000000000000011111111
10000000000002220000000000911111111111111111111111
10000000000000220000000000911111111111111111111111
10000000000000020000000000911111111111111111111111
18888888888888820000000001911111111111111111111111
11111111111111111111111111111111111111111111111111
